NO ./textures/north_texture.txt

SO ./textures/south_texture.txt

WE ./textures/west_texture.txt


EA ./textures/east_texture.txt

F 30,30,30
C 135,135,135




1111111111111111111111111111111111111
1111111111100000000000000111111111111
1111111111000000000000000111111111111
1111111110000000000000000111111111111
1111111100000000000000000111111111111
1111111000001111111100001111111111111
1111110000011111111000011111111111111
1111100000111111110000111111111111111
1111000001111111100001111111111111111
1111000000000000000001110111111111111
111100000000000110N001100111111111111
1111000000000001100001000111111111111
1111111111110001000100011111111111111
1111111111110001100011101011100100111
1111111111110001111111111111111111111
1111111111110001111111111111111111111
1111111111111111111111111111111111111